00 00 10 10 10 10 10 10 10 10 10 10 10 10 10 10 00 00
00 00 2 2 2 2 2 2 2 2 2 2 2 2 2 2 00 00
10 2 6 6 6 6 6 6 6 6 6 6 6 6 6 6 2 10
10 2 6 6 6 6 6 6 6 6 6 6 6 6 6 6 2 10
10 2 6 50 50 6 6 6 6 6 6 6 6 50 50 6 2 10
10 2 6 50 2 2 2 6 6 6 6 2 2 2 50 6 2 10
10 2 6 6 2 6 6 50 6 6 50 6 6 2 6 32 2 10
10 2 6 6 2 6 6 70 70 70 70 6 6 2 6 6 2 10
10 2 6 6 2 6 50 70 70 70 70 50 6 2 6 6 2 10
10 2 6 6 2 6 50 70 70 70 70 50 6 2 6 6 2 10
10 2 6 6 2 6 6 70 70 70 70 6 6 2 6 6 2 10
10 2 6 6 2 6 6 50 6 6 50 6 6 2 6 6 2 10
10 2 6 50 2 2 2 6 6 6 6 2 2 2 50 6 2 10
10 2 6 50 50 6 6 6 6 6 6 6 6 50 50 6 2 10
10 2 6 6 6 6 6 6 40 41 6 6 6 6 6 6 2 10
10 2 6 6 6 6 6 6 6 6 6 6 6 6 6 6 2 10
00 00 2 2 2 2 2 2 2 2 2 2 2 2 2 2 00 00
00 00 10 10 10 10 10 10 10 10 10 10 10 10 10 10 00 00