12 11 12 11 12 11 12 11 12 11 12 11 12 11 12 11 12 11
11 6 530 521 530 521 530 521 530 521 530 521 530 521 530 521 6 12
12 530 6 530 6 530 6 530 31 530 6 530 530 6 6 6 530 11
11 6 530 6 530 6 530 6 530 6 530 6 530 6 530 6 6 12
12 2 2 2 2 2 2 2 2 2 2 2 2 2 2 2 2 11
11 2 530 2 2 2 2 2 2 2 2 2 2 530 2 2 6 12
12 2 2 2 2 2 2 2 2 2 2 2 2 2 2 2 2 11
11 2 2 2 521 2 2 2 2 2 2 2 2 521 2 2 2 12
12 2 2 2 2 2 2 2 2 2 2 2 2 2 2 2 2 11
11 2 2 2 2 2 2 2 530 6 2 2 2 2 2 2 2 12
12 2 530 2 2 2 2 2 2 2 2 6 2 2 2 2 2 11
11 2 2 2 2 2 2 2 2 2 2 2 2 2 2 2 2 12
11 2 2 521 2 2 2 2 2 2 2 2 2 2 2 521 530 12
12 2 2 2 2 2 2 2 2 2 2 2 2 2 2 2 2 11
11 6 530 6 530 6 530 6 530 6 530 6 530 6 530 6 6 12
12 6 530 521 530 521 530 521 530 521 530 521 530 521 530 521 6 11
11 6 6 6 6 6 6 6 40 41 6 6 6 6 6 6 6 12
12 11 12 11 12 11 12 11 12 11 12 11 12 11 12 11 12 11