00 00 10 10 10 10 10 10 10 10 10 10 10 10 10 10 00 00
00 00 2 2 2 2 2 2 2 2 2 2 2 2 2 2 00 00
10 2 511 511 6 6 6 6 6 6 6 6 6 6 511 511 2 10
10 2 511 6 6 6 6 6 6 6 6 6 6 6 6 511 2 10
10 2 6 500 500 6 6 6 6 6 6 6 6 500 500 6 2 10
10 2 6 500 2 2 2 6 6 6 6 2 2 2 500 6 2 10
10 2 6 6 2 511 6 500 6 6 500 6 511 2 6 32 2 10
10 2 6 6 2 6 6 70 70 70 70 6 6 2 6 6 2 10
10 2 6 6 2 6 500 70 70 70 70 500 6 2 6 6 2 10
10 2 6 6 2 6 500 70 70 70 70 500 6 2 6 6 2 10
10 2 6 6 2 6 6 70 70 70 70 6 6 2 6 6 2 10
10 2 6 6 2 511 6 500 6 6 500 6 511 2 6 6 2 10
10 2 6 500 2 2 2 6 6 6 6 2 2 2 500 6 2 10
10 2 6 500 500 6 6 6 6 6 6 6 6 500 500 6 2 10
10 2 511 6 6 6 6 6 40 41 6 6 6 6 6 511 2 10
10 2 511 511 6 6 6 6 6 6 6 6 6 6 511 511 2 10
00 00 2 2 2 2 2 2 2 2 2 2 2 2 2 2 00 00
00 00 10 10 10 10 10 10 10 10 10 10 10 10 10 10 00 00