10 13 10 13 10 13 10 13 10 13 10 13 10 13 10 13 10 13
13 6 6 6 6 6 6 6 6 6 6 6 6 6 6 6 6 10
10 500 500 6 6 6 6 6 40 41 6 6 6 6 6 500 500 13
13 500 500 6 531 6 6 6 6 6 6 6 6 531 6 500 500 10
10 6 6 2 2 2 6 6 6 6 6 6 2 2 2 6 6 13
13 6 531 2 6 2 531 6 6 6 6 531 2 6 2 531 6 10
10 6 6 2 2 2 6 6 6 6 6 6 2 2 2 6 6 13
13 6 6 6 531 6 6 71 71 71 71 6 6 531 6 6 6 10
10 6 6 6 6 6 6 71 71 71 71 6 6 6 6 6 6 13
13 6 6 6 6 6 6 71 71 71 71 6 6 6 6 6 6 10
10 6 6 6 531 6 6 71 71 71 71 6 6 531 6 6 6 13
13 6 6 2 2 2 6 6 6 6 6 6 2 2 2 6 6 10
10 6 531 2 6 2 531 6 6 6 6 531 2 6 2 531 6 13
13 6 6 2 2 2 6 6 6 6 6 6 2 2 2 6 6 10
10 500 500 6 531 30 6 6 6 6 6 6 6 531 6 500 500 13
13 500 500 6 6 6 6 6 6 6 6 6 6 6 6 500 500 10
10 6 6 6 6 6 6 6 6 6 6 6 6 6 6 6 6 13
13 10 13 10 13 10 13 10 13 10 13 10 13 10 13 10 13 10