12 11 12 11 12 11 12 11 12 11 12 11 12 11 12 11 12 11
11 6 53 6 53 6 53 6 53 6 53 6 53 6 53 6 6 12
12 53 6 53 6 53 6 53 31 53 6 53 53 6 6 6 53 11
11 6 53 6 53 6 53 6 53 6 53 6 53 6 53 6 6 12
12 2 2 2 2 2 2 2 2 2 2 2 2 2 2 2 2 11
11 2 53 2 2 2 2 2 2 2 2 2 2 53 2 2 6 12
12 2 2 2 2 2 2 2 2 2 2 2 2 2 2 2 2 11
11 2 2 2 2 2 2 2 2 2 2 2 2 2 2 2 2 12
12 2 2 2 2 2 2 2 2 2 2 2 2 2 2 2 2 11
11 2 2 2 2 2 2 2 53 6 2 2 2 2 2 2 2 12
12 2 53 2 2 2 2 2 2 2 2 6 2 2 2 2 2 11
11 2 2 2 2 2 2 2 2 2 2 2 2 2 2 2 2 12
11 2 2 2 2 2 2 2 2 2 2 2 2 2 2 2 53 12
12 2 2 2 2 2 2 2 2 2 2 2 2 2 2 2 2 11
11 6 53 6 53 6 53 6 53 6 53 6 53 6 53 6 6 12
12 53 6 53 6 53 6 53 40 41 6 53 53 6 6 6 53 11
11 6 53 6 53 6 53 6 53 6 53 6 53 6 53 6 6 12
12 11 12 11 12 11 12 11 12 11 12 11 12 11 12 11 12 11