10 13 10 13 10 13 10 13 10 13 10 13 10 13 10 13 10 13
13 6 6 6 6 6 6 6 6 6 6 6 6 6 6 6 6 10
10 50 50 6 6 6 6 6 40 41 6 6 6 6 6 50 50 13
13 50 50 6 6 6 6 6 6 6 6 6 6 6 6 50 50 10
10 6 6 2 2 2 6 6 6 6 6 6 2 2 2 6 6 13
13 6 6 2 6 2 6 6 6 6 6 6 2 6 2 6 6 10
10 6 6 2 2 2 6 6 6 6 6 6 2 2 2 6 6 13
13 6 6 6 6 6 6 71 71 71 71 6 6 6 6 6 6 10
10 6 6 6 6 6 6 71 71 71 71 6 6 6 6 6 6 13
13 6 6 6 6 6 6 71 71 71 71 6 6 6 6 6 6 10
10 6 6 6 6 6 6 71 71 71 71 6 6 6 6 6 6 13
13 6 6 2 2 2 6 6 6 6 6 6 2 2 2 6 6 10
10 6 6 2 6 2 6 6 6 6 6 6 2 6 2 6 6 13
13 6 6 2 2 2 6 6 6 6 6 6 2 2 2 6 6 10
10 50 50 6 6 30 6 6 6 6 6 6 6 6 6 50 50 13
13 50 50 6 6 6 6 6 6 6 6 6 6 6 6 50 50 10
10 6 6 6 6 6 6 6 6 6 6 6 6 6 6 6 6 13
13 10 13 10 13 10 13 10 13 10 13 10 13 10 13 10 13 10